09-10-11-12-13-14-15-16-17
08-xx-xx-xx-xx-xx-xx-xx-18
07-xx-xx-xx-xx-xx-xx-xx-19 
06-xx-xx-xx-xx-xx-xx-xx-20
05-xx-xx-xx-xx-xx-xx-xx-21 
04-xx-xx-xx-xx-xx-xx-xx-22 
03-xx-xx-xx-xx-xx-xx-xx-23
02-xx-xx-xx-xx-xx-xx-xx-24
01-32-31-30-29-28-27-26-25
