09-10-11-12-13-14-15-16-17
08-39-40-41-42-43-44-45-18
07-38-xx-xx-xx-xx-xx-46-19 
06-37-xx-xx-xx-xx-xx-47-20
05-36-xx-xx-xx-xx-xx-48-21 
04-35-xx-xx-xx-xx-xx-49-22 
03-34-xx-xx-xx-xx-xx-50-23
02-33-xx-xx-xx-xx-xx-51-24
01-32-31-30-29-28-27-26-25
